NO .textures/north.xpm   
WE .textures/west.xpm


C 117,50,20

SO .textures/brickwall.xpm

EA .textures/east.xpm
F 80,100,30      


               11111111111111111111
               10000000000000000001
               10000000000000000001
               10000000000000000001
               10000000000000000001
11111111111111111111111110000111101
100000000000000001      100001  101
1000000000000000011111111000011110111111111111111111
1000000000000000000000000000000000000000000000000001
1000000000000000011111111111111111111111100000000001
100000000000000001                      100000000001
100000000000000001111111111111          100000000001
1000000000000000000000000000001         100000000001
100000000000000000000000000000011111111100000000001
10000000000000000000000000000000000000000000000001
1000000000000000000000000000000000000000000000001
10000000000000E000000000000000000000000000000001
10000000000000001111111111111111111111000000001
1000000000000000000000000000000000000000000001
 10000000000000000000000000000000000000000001
  100000000000000000000000000000000000000001
   1000000000000000000000000000000000000001
    11111111111111111111111111111111111111

