NO .textures/north.xpm   
WE .textures/west.xpm


C 117,50,20

SO .textures/brickwall.xpm

EA .textures/east.xpm
F 80,100,30      


1111111111111111111111111111111111111
1000000000000000000000000000000000001
1000000000000000000000000000000000001
1001001001001001001001001001001001001
1000000000000000000000000000000000001
1000000000000000000000000000000000001
1001001001001001001001001001001001001
1000000000000000E00000000000000000001
1000000000000000000000000000000000001
1001001001001001001001001001001001001
1000000000000000000000000000000000001
1000000000000000000000000000000000001
1001001001001001001001001001001001001
1000000000000000000000000000000000001
1000000000000000000000000000000000001
1111111111111111111111111111111111111
