NO .textures/north.xpm   
WE .textures/west.xpm


C 128,196,255

SO .textures/south.xpm

EA .textures/east.xpm
F 80,100,30     

11111111111111111111111111
1000000000100000110000001
10011100001000000111000101
100001011010000N0000000001
10110101001000000001111111
10000001000000000111
11111111111001001
          1000001
          1111111  
