NO .textures/north.xpm
WE .textures/west.xpm

C 255,128,10






SO .textures/south.xpm



EA .textures/east.xpm

F 100,80,255

1111111111111111111111111
100000000011000000000001
1011000001110000000000001
1001000000000000000000001
111111111011000001110000000000001
100000000011000001110111111111111
11110111111111011100000010001
111101111111110111010010010001
11000000110101011100000010001
10000000000000001100000010001
10000000000000001101010010001
110000011101010111110111100111
11110111 1110101 101111010001
11111111 1111111 111111111111
