NO .textures/north.xpm   
WE .textures/west.xpm


C 128,196,255

SO .textures/south.xpm

EA .textures/east.xpm
F 80,100,30     

11111111111111111111111111
10100001000100000110000001
11N10001010001000000111001101
101001010001000000111000101
110000010100000000000001
10111100001000000001111111
10000001000000000111
11111111111001001
          1000001
          1111111  
