NO .textures/north.xpm   
WE .textures/west.xpm


C 128,196,255

SO .textures/south.xpm

EA .textures/east.xpm
F 80,100,30     

11111111111111111111111111
11000001000100000110000001
10010001010001000000111001101
101001010001000000111000101
110000010100000000000001
10111100001000000001111111
10000001000000000111
11111111111001001
          1000001
          1111111  


111111111111111111111111111111111111111111111111111
100000000000000000000000000000000000000000000000001
100000000000000000000000000000000000000000000000001
100000000000000000000000000000000000000000000000001
100000000000000001001000010000000000000000000000001
100000000000000000000000000000000000000000000000001
100000000000000010000001000000000000000000000000001
100000000000000000001000000000000000000000000000001
1000000011111100000000000000000000000000000000000001
100000001000000000000000001000000000000000000000001
10000000100000000000100000000001000000000000000001
100000001000000000000000000000000000000000000000001
100000000001000001000001000010000000000000000000001
100000010000000000N00000000000000000000000000000001
100000000000100000000000000000001000000000000000001
100000000001000001000000001000000000000000000000001
100000000000001000000000000000000000000000000000001
100000000000000000001000000000000000000000000000001
100000000000010000000001001000000000000000000000001
100000000000000010000000000000000000000000000000001
100000000000000000001000000000000000000000000000001
100000000000000000000000000000000000000000000000001
100000000000000000000000000000000000000000000000001
100000000000000000000000000000000000000000000000001
100000000000000000000000000000000000000000000000001
10000000000000000000000000000000000000000000001111
1111111111111111111111111111111111111111111111
   
        1
       101
      10001
     1000001
    100000001
   1000000001
    100000001
     1000001
      10001
       101
        1
