NO .textures/north.xpm   
WE .textures/west.xpm


C 128,196,255

SO .textures/south.xpm

EA .textures/east.xpm
F 80,100,30     

1111111
1111111
1101E11
110 0111111111111111111111
111111
11111
101
111
