NO .textures/north.xpm   
WE .textures/west.xpm


C 128,196,255

SO .textures/south.xpm

EA .textures/east.xpm
F 80,100,30     

11111111111111111111111111
11000001000100000110000001
10010001010001000000111001101
101001010001000000111000101
110000010100W00000000001
10111100001000000001111111
10000001000000000111
11111111111001001
          1000001
          1111111  
