NO .textures/north.xpm   
WE .textures/west.xpm


C 117,50,20

SO .textures/brickwall.xpm

EA .textures/east.xpm
F 80,100,30      

111111111111111
100010000000101
111010111110101
100010001010101
101111101010101
101000101000101
1010101N1011101
100010101000001
111110101111111
100010100000001
101010111111101
101010100000001
101110101111101
100000001000001
111111111111111
