NO .textures/north.xpm   
WE .textures/west.xpm


C 117,50,20

SO .textures/brickwall.xpm

EA .textures/east.xpm
F 80,100,30      

1111111111111111111111111111111
1000000000000000000000000000001
1000100010001000100010001000101
1000000000000000000000000000001
1001000100010001000100010001001
1000000000000000000000000000001
1010001000100010001000100010001
1000000000000000000000000000001
1000100010001000100010001000101
10000000000000N0000000000000001
1001000100010001000100010001001
1000000000000000000000000000001
1010001000100010001000100010001
1000000000000000000000000000001
1000100010001000100010001000101
1000000000000000000000000000001
1001000100010001000100010001001
1000000000000000000000000000001
1010001000100010001000100010001
1111111111111111111111111111111
