NO .textures/north.xpm   
WE .textures/west.xpm


C 117,50,20

SO .textures/brickwall.xpm

EA .textures/east.xpm
F 80,100,30      

1111111111111111111111111111111
1000000000000000000000000000001
1010101010101010101010101010101
1000000000000000000000000000001
1010101010101010101010101010101
1000000000000000000000000000001
1010101010101010101010101010101
1000000000000000000000000000001
1010101010101010101010101010101
100000000000000N000000000000001
1010101010101010101010101010101
1000000000000000000000000000001
1010101010101010101010101010101
1000000000000000000000000000001
1010101010101010101010101010101
1000000000000000000000000000001
1010101010101010101010101010101
1111111111111111111111111111111
